d,d,d,d,s,d,d,d,d,d,d,r,r,r,r,r,r,r,r,r
d,d,d,d,s,d,d,d,d,d,d,d,d,d,d,d,d,d,d,d
d,d,d,d,s,d,d,d,d,r,r,d,d,d,d,d,d,d,d,d
d,d,d,d,s,d,d,d,r,1,1,r,d,d,r,d,d,r,d,d
d,d,d,d,s,d,d,r,e,e,e,e,r,d,d,d,r,d,d,d
d,d,d,d,s,d,d,e,e,d,d,e,e,d,e,r,d,d,d,d
d,d,d,d,v,d,d,e,e,d,d,e,r,1,s,d,d,d,d,r
d,d,d,d,r,r,r,d,d,d,d,d,r,r,s,d,d,d,d,r
d,d,d,r,r,r,r,r,d,d,d,d,d,d,s,d,d,d,1,r
d,d,d,e,e,e,e,e,d,d,d,d,d,d,s,d,d,r,r,r
